G000000000
1111111110
0000000010
0111111010
0100001010
0101S01010
0101111010
0100000010
0111111110
0000000000