S000111111
1111111111
1111111111
1111111111
1111111111
1111111111
1111111111
1111111111
1111111111
000011110G