S000000000
0110111110
0100000000
0101011111
0100000000
0111110110
0100000000
0101111111
0110001000
000010001G